
+---+---+---+			1. espiral
|   |       |
+   +   +   +
|   |   |   |
+   +---+   +
|           |
+---+---+---+

+---+---+---+			1s. espiral simétrico
|       |   |
+   +   +   +
|   |   |   |
+   +---+   +
|           |
+---+---+---+

+---+---+---+			2. zigzag
|       |   |
+   +   +   +
|   |   |   |
+   +   +   +
|   |       |
+---+---+---+

+---+---+---+			3. pasillos (simétrico)
|   |   |   |
+   +   +   +
|   |   |   |
+   +   +   +
|           |
+---+---+---+

+---+---+---+			2s. zigzag simétrico
|   |       |
+   +   +   +
|   |   |   |
+   +   +   +
|       |   |
+---+---+---+

+---+---+---+			4. pasillos en 'L'
|   |   |   |
+   +   +   +
|   |       |
+   +---+   +
|           |
+---+---+---+

+---+---+---+			5. curvas en 'S'
|   |       |
+   +   +---+
|   |       |
+   +---+   +
|           |
+---+---+---+

+---+---+---+			volvemos a 4. pasillos en 'L'
|   |   |   |
+   +   +   +
|   |       |
+   +---+   +
|           |
+---+---+---+

+---+---+---+			4s. pasillos en 'L' simétrico
|   |   |   |
+   +   +   +
|       |   |
+   +---+   +
|           |
+---+---+---+

+---+---+---+			5s. curvas en 'S' simétrico
|       |   |
+---+   +   +
|       |   |
+   +---+   +
|           |
+---+---+---+

+---+---+---+			volvemos a 4s. pasillos en 'L' simétrico
|   |   |   |
+   +   +   +
|       |   |
+   +---+   +
|           |
+---+---+---+

+---+---+---+			6. giros alternados
|   |       |
+   +   +---+
|       |   |
+   +---+   +
|           |
+---+---+---+

+---+---+---+			7. camino cerrado
|           |
+---+   +---+
|       |   |
+   +---+   +
|           |
+---+---+---+

+---+---+---+			8. giros concatenados
|           |
+---+   +---+
|           |
+   +---+   +
|       |   |
+---+---+---+

+---+---+---+			8s. giros concatenados simétrico
|           |
+---+   +---+
|           |
+   +---+   +
|   |       |
+---+---+---+

+---+---+---+			7s. camino cerrado simétrico
|           |
+---+   +---+
|   |       |
+   +---+   +
|           |
+---+---+---+

+---+---+---+			6s. giros alternados simétrico
|       |   |
+---+   +   +
|   |       |
+   +---+   +
|           |
+---+---+---+

+---+---+---+			9. abriendo ramas
|       |   |
+---+   +   +
|   |       |
+   +   +---+
|           |
+---+---+---+

+---+---+---+			10. ramas radiales
|       |   |
+---+   +   +
|           |
+   +   +---+
|   |       |
+---+---+---+

+---+---+---+			volvemos a 9. abriendo ramas
|       |   |
+---+   +   +
|   |       |
+   +   +---+
|           |
+---+---+---+

+---+---+---+			11. curvas en 'S' con salida
|       |   |
+   +   +   +
|   |       |
+---+   +---+
|           |
+---+---+---+

+---+---+---+			12. pasillos con salida (simétrico)
|   |   |   |
+   +   +   +
|           |
+---+   +---+
|           |
+---+---+---+

+---+---+---+			11s. curvas en 'S' con salida simétrico
|   |       |
+   +   +   +
|       |   |
+---+   +---+
|           |
+---+---+---+

+---+---+---+			9s. abriendo ramas simétrico
|   |       |
+   +   +---+
|       |   |
+---+   +   +
|           |
+---+---+---+

+---+---+---+			10s. ramas radiales simétrico
|   |       |
+   +   +---+
|           |
+---+   +   +
|       |   |
+---+---+---+

+---+---+---+			volvemos a 9s. abriendo ramas simétrico
|   |       |
+   +   +---+
|       |   |
+---+   +   +
|           |
+---+---+---+

+---+---+---+			13. abriendo ramas con pasillo en 'L'
|   |       |
+   +   +   +
|       |   |
+---+   +   +
|       |   |
+---+---+---+

+---+---+---+			14. abriendo ramas con pasillo en 'U'
|           |
+---+   +   +
|       |   |
+   +   +   +
|   |   |   |
+---+---+---+

+---+---+---+			15. pasillo en 'U' con salida
|   |       |
+   +   +   +
|       |   |
+   +   +   +
|   |   |   |
+---+---+---+

+---+---+---+			15s. pasillo en 'U' con salida simétrico
|   |   |   |
+   +   +   +
|       |   |
+   +   +   +
|   |       |
+---+---+---+

+---+---+---+			14s. abriendo ramas con pasillo en 'U' simétrico
|   |   |   |
+   +   +   +
|       |   |
+---+   +   +
|           |
+---+---+---+

+---+---+---+			13s. abriendo ramas con pasillo en 'L' simétrico
|       |   |
+---+   +   +
|       |   |
+   +   +   +
|   |       |
+---+---+---+

